28 12
21;1 01;3 01;3 01;3 01;3 01;3 01;3 01;3 01;3 01;3 01;3 01;3 01;1 01;1 01;1 01;1 01;1 01;1 01;1 01;1 01;1 01;1 01;1 01;1 01;7 01;7 30;7 01;7
01;3 34;7 35;3 01;3 01;3 01;1 01;3 01;3 01;3 35;7 34;1 01;3 01;1 12;3 11;3 11;3 12;5 01;1 01;1 12;3 11;3 11;3 12;5 01;1 01;7 01;7 28;7 01;7
01;3 35;5 03;1 05;3 05;3 05;3 05;3 05;3 05;3 05;3 35;5 01;3 17;1 11;1 03;1 01;1 11;5 04;1 01;1 11;1 03;1 01;1 11;5 01;1 01;7 01;7 01;7 01;7
01;3 01;3 05;1 04;1 05;7 05;7 09;7 05;7 04;1 05;5 01;3 01;3 01;1 11;1 21;1 03;1 11;5 01;1 01;1 11;1 22;1 03;1 11;5 01;1 01;7 01;7 26;7 01;7
01;3 01;3 05;1 05;5 34;7 35;3 05;1 01;3 05;1 05;5 01;3 01;3 01;1 12;1 11;7 11;7 12;7 01;1 04;1 12;1 11;7 11;7 12;7 01;1 01;7 01;7 01;7 01;7
01;3 18;1 05;1 05;5 35;5 22;1 05;1 01;3 05;1 05;5 01;3 01;3 01;1 01;1 01;1 01;1 04;1 01;1 01;1 01;1 01;1 04;1 01;1 01;1 01;7 01;7 24;7 01;7
01;3 01;3 05;1 05;5 01;3 05;5 01;3 35;1 05;1 05;5 01;1 01;3 01;1 01;1 04;1 01;1 01;1 01;1 01;1 04;1 01;1 01;1 19;1 01;1 01;7 01;7 23;7 01;7
01;3 01;3 05;1 05;5 01;3 05;5 35;7 34;3 05;1 05;5 01;3 01;3 01;1 12;3 11;3 11;3 12;5 04;1 01;1 12;3 11;3 11;3 12;5 01;1 01;7 01;7 01;7 01;7
01;3 01;3 05;1 04;1 05;3 09;3 05;3 05;3 04;1 05;5 01;3 01;3 01;1 11;1 03;1 22;1 11;5 01;1 01;1 11;1 03;1 21;1 11;5 01;1 01;7 01;7 25;7 01;7
01;3 35;1 03;1 05;7 05;7 05;7 05;7 05;7 05;7 05;5 35;1 01;3 01;1 11;1 01;1 03;1 11;5 01;1 04;1 11;1 01;1 03;1 11;5 01;1 01;7 01;7 01;7 01;7
01;3 34;5 35;3 01;3 01;3 01;3 01;3 01;3 01;3 35;7 34;3 01;3 01;1 12;1 11;7 11;7 12;7 01;1 01;1 12;1 11;7 11;7 12;7 01;1 01;7 01;7 27;7 01;7
01;3 01;3 01;3 01;3 01;3 01;3 01;3 01;1 01;3 21;1 01;3 01;3 01;1 01;1 01;1 01;1 01;1 01;1 01;1 01;1 01;1 01;1 01;1 01;1 01;7 01;7 29;7 01;7
0 0 1;1 0 1;1 0 0 1;1 0 1;1 0 0 0 0 1;1 0 1;1 0 0 1;1 0 1;1 0 0 0 0 1;5 0
0 0 0 0 0 0 0 0 0 0 0 0 0 0 0 0 0 0 0 0 0 0 0 0 0 0 0 0
1;7 0 0 0 0 0 1;5 0 0 0 0 1;3 1;7 0 0 1;5 0 0 0 0 0 0 0 1;3 1;7 0 1;5 1;3
0 0 0 0 0 0 0 0 0 0 0 0 0 0 0 0 0 1;7 3;3 0 0 0 0 0 0 0 0 0
1;7 0 0 0 0 0 0 0 0 0 0 1;3 1;7 0 0 0 0 0 0 0 0 0 0 1;3 1;7 0 1;5 1;3
0 0 0 0 0 0 0 0 0 0 0 0 0 0 0 0 0 0 0 0 3;1 0 0 0 0 0 1;5 0
0 0 1;3 0 0 0 0 0 0 1;7 0 0 0 0 0 3;5 0 0 0 0 0 0 0 0 0 0 1;5 0
1;7 0 0 0 0 0 0 0 0 0 0 1;3 1;7 0 0 0 0 0 0 0 0 0 0 1;3 1;7 0 0 1;3
0 0 0 0 0 0 0 0 0 0 0 0 0 0 0 0 0 3;7 1;3 0 0 0 0 0 0 0 1;5 0
1;7 0 0 0 0 1;1 0 0 0 0 0 1;3 1;7 0 0 0 0 0 0 0 1;1 0 0 1;3 1;7 0 0 1;3
0 0 0 0 0 0 0 0 0 0 0 0 0 0 0 0 0 0 0 0 0 0 0 0 0 0 1;5 0
0 0 1;5 0 1;5 0 0 1;5 0 1;5 0 0 0 0 1;5 0 1;5 0 0 1;5 0 1;5 0 0 0 0 0 0