28 12
21;01 01;03 01;03 01;03 01;03 01;03 01;03 01;03 01;03 01;03 01;03 01;03 01;1 01;1 01;1 01;1 01;1 01;1 01;1 01;1 01;1 01;1 01;1 01;1 01;07 01;07 30;07 01;07
01;03 34;07 35;03 01;03 01;03 01;01 01;03 01;03 01;03 35;07 34;01 01;03 01;1 12;3 11;3 11;3 12;5 01;1 01;1 12;3 11;3 11;3 12;5 01;1 01;07 01;07 28;07 01;07
01;03 35;05 03;01 05;03 05;03 05;03 05;03 05;03 05;03 05;03 35;05 01;03 17;7 11;1 03;1 01;1 11;5 04;1 01;1 11;1 03;1 01;1 11;5 01;1 01;07 01;07 01;07 01;07
01;03 01;03 05;01 04;01 05;07 05;07 09;07 05;07 04;01 05;05 01;03 01;03 01;1 11;1 21;1 03;1 11;5 01;1 01;1 11;1 22;1 03;1 11;5 01;1 01;07 01;07 26;07 01;07
01;03 01;03 05;01 05;05 34;07 35;03 05;01 01;03 05;01 05;05 01;03 01;03 01;1 12;1 11;7 11;7 12;7 01;1 04;1 12;1 11;7 11;7 12;7 01;1 01;07 01;07 01;07 01;07
01;03 18;07 05;01 05;05 35;05 22;01 05;01 01;03 05;01 05;05 01;03 01;03 01;1 01;1 01;1 01;1 04;1 01;1 01;1 01;1 01;1 04;1 01;1 01;1 01;07 01;07 24;07 01;07
01;03 01;03 05;01 05;05 01;03 05;05 01;03 35;01 05;01 05;05 01;01 01;03 01;1 01;1 04;1 01;1 01;1 01;1 01;1 04;1 01;1 01;1 19;7 01;1 01;07 01;07 23;07 01;07
01;03 01;03 05;01 05;05 01;03 05;05 35;07 34;03 05;01 05;05 01;03 01;03 01;1 12;3 11;3 11;3 12;5 04;1 01;1 12;3 11;3 11;3 12;5 01;1 01;07 01;07 01;07 01;07
01;03 01;03 05;01 04;01 05;03 09;03 05;03 05;03 04;01 05;05 01;03 01;03 01;1 11;1 03;1 22;1 11;5 01;1 01;1 11;1 03;1 21;1 11;5 01;1 01;07 01;07 25;07 01;07
01;03 35;01 03;01 05;07 05;07 05;07 05;07 05;07 05;07 05;05 35;01 01;03 01;1 11;1 01;1 03;1 11;5 01;1 04;1 11;1 01;1 03;1 11;5 01;1 01;07 01;07 01;07 01;07
01;03 34;05 35;03 01;03 01;03 01;03 01;03 01;03 01;03 35;07 34;03 01;03 01;1 12;1 11;7 11;7 12;7 01;1 01;1 12;1 11;7 11;7 12;7 01;1 01;07 01;07 27;07 01;07
01;03 01;03 01;03 01;03 01;03 01;03 01;03 01;01 01;03 21;01 01;03 01;03 01;1 01;1 01;1 01;1 01;1 01;1 01;1 01;1 01;1 01;1 01;1 01;1 01;07 01;07 29;07 01;07
0 0 1;1 0 1;1 0 0 1;1 0 1;1 0 0 0 0 1;1 0 1;1 0 0 1;1 0 1;1 0 0 0 0 1;5 0
0 0 0 0 0 0 0 0 0 0 0 0 0 0 0 0 0 0 0 0 0 0 0 0 0 0 0 0
1;7 0 0 0 0 0 1;5 0 0 0 0 1;3 1;7 0 0 1;5 0 0 0 0 0 0 0 1;3 1;7 0 1;5 1;3
0 0 0 0 0 0 0 0 0 0 0 0 0 0 0 0 0 1;7 3;3 0 0 0 0 0 0 0 0 0
1;7 0 0 0 0 0 0 0 0 0 0 1;3 1;7 0 0 0 0 0 0 0 0 0 0 1;3 1;7 0 1;5 1;3
0 0 0 0 0 0 0 0 0 0 0 0 0 0 0 0 0 0 0 0 3;1 0 0 0 0 0 1;5 0
0 0 1;3 0 0 0 0 0 0 1;7 0 0 0 0 0 3;5 0 0 0 0 0 0 0 0 0 0 1;5 0
1;7 0 0 0 0 0 0 0 0 0 0 1;3 1;7 0 0 0 0 0 0 0 0 0 0 1;3 1;7 0 0 1;3
0 0 0 0 0 0 0 0 0 0 0 0 0 0 0 0 0 3;7 1;3 0 0 0 0 0 0 0 1;5 0
1;7 0 0 0 0 1;1 0 0 0 0 0 1;3 1;7 0 0 0 0 0 0 0 1;1 0 0 1;3 1;7 0 0 1;3
0 0 0 0 0 0 0 0 0 0 0 0 0 0 0 0 0 0 0 0 0 0 0 0 0 0 1;5 0
0 0 1;5 0 1;5 0 0 1;5 0 1;5 0 0 0 0 1;5 0 1;5 0 0 1;5 0 1;5 0 0 0 0 0 0